XX_TXTXX
___XX_XX
XX____XX
FXX_XXXX
__X____X
X_X_XX_X
X___X__W
XXTXF_XX