X__________
X_XXXXXXXX_
__XTX___TX_
_XX_X_XXXX_
_TX_____XX_
_XX_XXX_XX_
_XX_XXX_TX_
_XX_XT__XX_
_____XX_XX_
FXXXXXX_XX_
XXW_____XXX