__________F
_XTXTXXX_XX
_XXXXXXX_XT
_XT______X_
_XXX_XXX_X_
_X___XXTXX_
_X_X_XX_XX_
_X_X_______
_XTXXXTXXXX
_XXXXXXXXXX
__________W
