XXTWXXX
X___XXX
X_X___F
X_XXXXX
X__TXXX
XT_X_TX
XX___XX
