TXXXXTXXF
_________
X_XXX_XXX
X_XT_____
T_XXXTXX_
X_XXXXXXT
X_______X
XXXTXXX_W
XXXXXXXXX
