XXX_____XXXX
XXX_XXX_XXXX
X___XXX_XXXX
XXXXXXX_XXXX
XXXXXXX_____
XXXXXXXX_X__
XXXXXXXXXX__
_XXXX_XXXX__
__X___XXXX__
X_X_XX___X__
X_X_XX_X____
X______XXXX_
