XXFXXXW__XXT
XX_XXXXX____
XX_XXXXXXXX_
___TXXXT____
_XXXXXXX_XX_
_XXXXXT__XX_
_XXXXXXXX___
_____XXXX_XX
XXXX__TXX__T
XXXX_XXXXX_X
XXXX_______X
XXXXXXXXXXXX
