X___TXFX
T_X_X__X
X_X_X_XX
T_X____T
X_X_XX_X
X_X____T
T_X_XXXX
XXX____W